7
18
###E###
#    ##
# ### #
#  ## #
## #  #
#  # ##
##    # 
#### ##
#     #
#### ##
# #  ##
#     #
##### #
#     #
# ## ##
#   ###
# # ###
###S###